###################################################
####    ####  # #   # #  #  ##  ### ##  ### #F    #
#       ##        # #   # ######   #       #      #
# #         #  ##      # #    ##  #    ## ##      #
#   # # #  ## ##   # #  ###     ## ####  #  #     #
# #    #     ####   # #        #     ##       #####
#  # # # #   #    ####  ##     # #    ##    # ##  #
#      #    ##          # #  #    #  ##  # #     ##
## # # #   # # ##   # # ##   #    ## #  #     #   #
#   #   ### # # # #  ###     ## # # ##      #  #  #
#    #  ##    # # # #  #   ##   # # ###  #    ##  #
##      #  #  #    ### # # ##    ##       #      ##
##    #   # ###    ##     #  #  ##   #   #   #    #
#    # #  #     ##  #      #  ##      # #  #  #   #
##           ######   #       ##    #  #  # ## #  #
##  # #   # ##    ###   # ###         # ##    #   #
# ## ###      #   #    #      #    ##  ### # # # ##
# #     ###  ##  ## #  #    ###  ##  ##    #      #
#        ##      #    #   ##   #  ###   #  #    # #
#      #      ##   #   #     # #  #  #            #
#                  #   ##             # #  ##  # ##
#S #    #   # ##    #   S##  # #  #  #   ## #     #
##   #      #  # # #   #     ## #  ##     #  #  # #
## #    #  ## #     ### ###     ##      #  #  #  ##
#   #       ####  ##   ##  #  ##  #    ##       ###
## ## #  #          #   ###    ##   #  #     ##   #
#  ## #            ## #       ##  ##          # # #
##   #    ## #   S##  #     #      # #  #        ##
#  # #  #   #    #  ## ##  #    ##  # #   ##      #
#    ##  #   #  ##  #   # #  ##   # #       ##    #
###################################################
